###########################################################
###########################################################
###########################################################
###########################################################
#####                ######################################
#####                ######################################
#####                ######################################
#####                ######################################
############ #  ###########################################
###                     ###################################
###  o                  ###################################
###                     ###################################
### o                                  ####################
###                     ##############  ###################
###                     ###############  ##################
###                     ################  #################
###      o              ##########                 ########
############ ####  ####  #########        e        ########
############ #####  ####  ########                 ########
############ ###### #####  #######                 ########
############  ##### ######  ###############################
#############  #### #######                     ###########
##############  ### #######o                    ###########
###############  ## #######          E          ###########
################  # #######                $    ###########
#################   #######                     ###########
###############          ##################################
###############          ##################################
###############          ##################################
###############          ##################################
###########################################################
###########################################################
###########################################################
###########################################################
###########################################################
###########################################################
###########################################################
###########################################################
###########################################################
###########################################################
